s	3	4	2	4	1	5	
2	4	4	2	5	g	1
3	4	6	5	4	4	2
1	4	2	3	1	1	3
4	5	5	2	1	2	3
2	2	1	1	5	5	3