1	2	3	4	5	6
2	3	4	5	6	G
3	4	5	6	1	2
4	5	6	1	2	3
5	6	1	2	3	4
6	S	2	3	4	5
