7	7	7	7	7	7	7	7	g
7	6	6	6	6	6	6	6	7
7	6	5	5	5	5	5	6	7
7	6	5	4	4	4	5	6	7
7	6	5	4	3	4	5	6	7
7	6	5	4	4	4	5	6	7
7	6	6	6	6	6	6	6	7
s	7	7	7	7	7	7	7	7