1	1	1	1	9	9	9	1	1	1	1
1	1	S	1	9	9	9	1	1	1	1
1	1	1	1	9	9	9	1	1	1	1
1	1	1	1	9	9	9	1	1	1	1
1	1	1	1	9	9	9	1	1	1	1
1	1	1	1	9	9	9	1	1	G	1
1	1	1	1	9	9	9	1	1	1	1
1	1	1	1	9	9	9	1	1	1	1
1	1	1	1	9	9	9	1	1	1	1
1	1	1	1	1	9	9	1	1	1	1
1	1	1	1	1	9	9	1	1	1	1
1	1	1	1	1	9	9	1	1	1	1
1	1	1	1	1	9	9	1	1	1	1
1	1	1	1	1	9	9	1	1	1	1
1	1	1	1	1	9	9	1	1	1	1
1	1	1	1	1	1	9	1	1	1	1
1	1	1	1	1	1	9	1	1	1	1
1	1	1	1	1	1	9	1	1	1	1
1	1	1	1	1	1	9	1	1	1	1
1	1	1	1	1	1	9	1	1	1	1
1	1	1	1	1	1	9	1	1	1	1
1	1	1	1	1	1	9	1	1	1	1
