1	1	1	1	9	9	9	1	1	1	1
1	1	s	1	9	9	9	1	1	1	1
1	1	1	1	9	9	9	1	1	1	1
1	1	1	1	9	9	9	1	1	1	1
1	1	1	1	9	9	9	1	1	1	1
1	1	1	1	9	9	9	1	1	g	1
1	1	1	1	9	9	9	1	1	1	1
1	1	1	1	9	9	9	1	1	1	1
1	1	1	1	9	9	9	1	1	1	1
1	1	1	1	1	9	9	1	1	1	1
1	1	1	1	1	9	9	1	1	1	1
1	1	1	1	1	9	9	1	1	1	1
1	1	1	1	1	9	9	1	1	1	1
1	1	1	1	1	9	9	1	1	1	1
1	1	1	1	1	9	9	1	1	1	1
1	1	1	1	1	1	9	1	1	1	1
1	1	1	1	1	1	9	1	1	1	1
1	1	1	1	1	1	9	1	1	1	1
1	1	1	1	1	1	9	1	1	1	1
1	1	1	1	1	1	9	1	1	1	1
1	1	1	1	1	1	9	1	1	1	1
1	1	1	1	1	1	9	1	1	1	1