1	2	3	4	5	6
2	3	4	5	6	g
3	4	5	6	1	2
4	5	6	1	2	3
5	6	1	2	3	4
6	s	2	3	4	5
	
